998 13 31
###############################
#                             #
# #   #  #   #   # ### ##   # #
# #   #  #   #   #  #  # #  # #
# #   #  #   #   #  #  #  # # #
# #   #   # # # #   #  #   ## # 
#  ###     #   #   ### #    # #
#                             #
#         ##########          #
#         #  1234  #          #
#         ##########          #
#              p              #
###############################

