999 13 31
###############################
#                             #
# #   #  #     ##   ###  ###  #
# #   #  #    #  #  #    #    #
# #   #  #    # p#   #   ###  #
# #   #  #    #  #    #  #    #
#  ###   ###   ##   ###  ###  #
#                             #
#       1           3         #
#                             #
#       2           4         #
#                             #
###############################

